1111111111111
1000000020001
1N00000000001
1000002000001
1000000000001
1111111111111